source	original	como adjetivo, salvo si acompaña a "language", a "tokenizer" o a "term"
source	de origen	cuando acompaña a "language", a "tokenizer" y a "term", de lo contrario usar "original"
target	traducido	como adjetivo, salvo si acompaña a "language" o a "term"
target	de destino	cuando acompaña a "language" o a "term"
e.g.	por ejemplo	preferir situarlo al final.
Scripting window	ventana Programación
Shift	Mayús
Modification Info	Información de modificación
TransTips	Consejos de traducción
OmegaT	OmegaT
version control	control de versiones
writeable glossary	glosario principal	mejor que "glosario editable"
tokenizer	analizador	Según lo explicado en el mensaje del grupo (ver URL), "tokenizer" es, en jerga de Lucene, un "analizador".
nbsp	espacio de no separación
team	trabajo en grupo
team project	proyecto de trabajo en grupo
entry	término	cuando se refiere al glosario; de lo contrario "entrada"
Legal notices	Aviso legal
OmegaT on the web	OmegaT en la web
Editing Behavior	Comportamiento del campo de edición
fuzzy matches	coincidencias proximadas
Editing behaviour	Comportamiento del campo de edición
Subfolder	Subcarpeta
Backups	copias de seguridad
User settings files	Archivos de configuración del usuario
Plain text files	Archivos de texto sin formato
File formats	Formatos de archivo
PO as bilingual files	PO como archivos bilingües
greedy quantifier	cuantificador expansivo	Greedy quantifier
reluctant quantifier	cuantificador diferido
computer	equipo	forma neutra en reemplazo de las formas locales "ordenador" "computadora" "máquina" o "computador"
abort	cancelar	1. definition: to stop an activity because it would be difficult or dangerous to continue it
initialize	iniciar	if a computer initializes or is initialized, certain important programs are prepared so that it can start running
clear	borrar
reload	volver a cargar
quit	salir
match	coincidencia
remove	eliminar
parse error	error de análisis
fatal error	error irrecuperable
TMX level2	nivel 2 de TMX
add	añadir
plugin	complemento
form-feed character	carácter de salto de página
override	anular
Project files	Archivos del proyecto
